1,0,0,1,1,1,43,43,41,41,40,41,22,21,0
0,0,0,1,1,43,1,40,20,20,1,20,42,0,20
0,0,1,1,1,0,0,1,40,41,41,22,41,21,40
0,0,0,0,0,0,1,1,41,42,23,42,22,20,22
1,0,0,0,1,1,0,0,43,43,43,43,21,0,42
0,1,1,1,0,1,0,0,42,42,42,42,43,21,42
1,0,0,0,0,1,1,185,168,168,184,23,42,43,40
0,0,1,0,1,1,1,167,164,164,162,23,42,42,1
21,0,0,1,0,1,1,163,161,161,160,23,23,23,21
0,1,41,42,1,1,0,0,41,41,41,41,23,23,23
